00000000000000000000000000000000000000000
00000000000000000000000000000000000000000
00000000000000000000000000000000000000000
00000000000000000000000000000000000000000
00000000000000000000000000000000000000000
0000AAAAAAAAAA000000000000000000000000000
00000000000000000000000000000000000000000
70000000000000000000000000000000000000000
70000000000000000000000000000000000000000
79900000000000000000000000000000000000000
7000L000000000000000000001111111100000000
7000L000000R000XXXXXXXXXXSS11X00000000000
7000LXXXXXXR000X0000000000000X0000R00000L
700000000000000X0000000000000X0000EEEEEEE
788000000000000X0000000000000X00000000000
000000000000000X0000000000000X00000000000
000000000000000X0000000000000200000000000
666666000000000XXXXXXXXXX0000200000000000
000000000020000000000000X0000000000000000
000000000000000000000000X0000000000000000
000444000000000000000000X0000000000000000
444444000000000000000000X0000000000000000
444444033333000XXXXXXXXXX0000000000000000
