00000000000011111110000000111100000000000
00000000000000111000000000011000000000000
00000000000000011000000000000000000000000
00000000000000011100000000000000000000000
00000000000000010000000000000000000000000
00000000000000000000000000000000000000000
00000000000000000000000000000000000000000
00000000000000000000000000000000000000000
00000000000000000000SSSS00000000000000000
00000000000000000000000000000000000000000
0000000000000000000000000000000000SSSSSSS
00000000S000333SS000000000000000000SSSSSS
0000000200022PS2P00000066000000000P0SSSSS
000000S000000000000XXXXXX00999990PP0LLLL0
XXXXXX000000000000PXXXXXX0000000000000000
000000000000000000000XXXX0000000000000000
00000000000000000000000000000000000000000
00000000000000000000000000000000000000000
00000000000000000000000000000000000000000
00000000400000000000000000000000000000000
00000500000500004000000066666666666000000
000000000000000000000000088888000XXXX000X
00000000000000000000000000000000000000000
