0000000000XX00000000000000000010000000000
0000000000XX00000000000000000010000000000
0000000000XX00000000000000000010000000000
0000000000XX0000000000000000XXX0000000000
XXX0000000XX000033333333330000X0000000000
XXX0000000XX000000333333300000X0000111111
XXX0000000XX000000000000000000X0000000000
XXX0000000XX000000000000000000X0000000555
0000000000XXSSS000000000000000X0000000000
0000000000XXSSS000000000000000XS000000000
0000000000XXSSS444400000000000X0V00000000
0000000000XX000000000000000000X0000000000
0000004444XX000000000000000000X0000000000
000000000000000000000000000000EE0000000VV
00000000000000000000000000000000000000000
00000000000000000000000000000000000000000
00000555555500000000000000000000000000000
000000000333000000000000000000000000000LL
60000000000000000000000000000000000000000
00000000000000000000000000000006666600000
00000000000000070000700000000000000000000
0000000000000007DDDD700000000000000000000
0000000000000000DDDD0000000000000000XXXXX
