00000000000000000000000000000000000000000
00000000000000000000000000000000000000000
00000000000000000000000000000000000000000
00000000000000000000000000000000000000000
00000000000000000000000000000000000000000
00000000000000000000000000000000000000000
00000000000000000000000000000000000000000
00000000000000000000000000000000000000000
00000000000000000000000000000000000000000
00000000000000000000000000000000000000000
00000000000000000000000000000000000000000
00000000000000000000000000000000000000000
00000000000000000000000000000000000000000
00000000000000000000000000000000000000000
XXXXXXSSSSSSSSSSXXXXXXSSSSSSSSSSSXXXXXXXX
XXXXXX0000000000XXXXXX00000000000XXXXXXXX
XXXXXX0000000000XXXXXX00000000000XXXXXXXX
XXXXX0000000000000000000000000000000XXXXX
00000000000000000000000000000000000000000
00000000000000000000000000000000000000000
00000000000000000000000000000000000000000
11111111111111111111111111111111111111111
11111111111111111111111111111111111111111
