00000000000000000000000000000000000000000
00000000000000000000000000000000000000000
00000000000000000000000000000000000000000
00000000000000000000000000000000000000000
00000000000000000000000000000000000000000
0000AAAAAAAAAA000000000000000000000000000
00000000000000000000000000000000000000000
70000000000000000000000000000000000000000
70000000000000000000000000000000000000000
79900000000000000000000000000000000000000
70000000000000000000000001111110000000000
70000L00000S000000XXXXXXXSS11X00000000000
70000XXXXXXS000000X000000000PX0000P00000L
700000000000000011X000000000PX0000EEEEEEE
780000000000000000X000000000PX00000000000
00000000000000SS00X000000000PX00000000000
0000000000000SS000X000000000PPXX000000000
66666600000000000XXXXXXXX000PPPPP00000000
000000000000000000000000X0000000000000000
000000000020000000000000X0000000000000000
000444000000000000000000X0000000000000000
444444000000000000000000X0000000000000000
444444033333000XXXXXXXXXX0000000000000000
